
*****************************
  *   *    ****  **     ** **
* * *   ** *   *    * *    **
* * ** * * *** ** * *** *****
* **   * * *      *   *     *
* ** ***   *** ****** *** * *
*    *** ***   *      **  * *
******** *** *** ******  ** *
*   *        *   *      **  *
* *   ******** ********** ***
* ****  *      **    **    **
*    ** * ******  **    **  *
****    * **     ************
*    ****    * *             
*****************************
